                        NO ./path_to_the_north_texture
SO ./path_to_the_south_texture





                                  
WE ./path_to_the_west_texture


                       


                                
EA ./path_to_the_east_texture









F 41,40,38
C 150,50,255

111111111111111111111111111111111
100000000000000000000000000000001
10000000000000000000000000000E001
111111111111111111111111111111111


                     
                      
                       
                        
                         
                                                 

					  
					   
					    



                                             
                 
                                            



                    
