NO ./path_to_the_north_texture
SO ./path_to_the_south_texture





                                  
WE ./path_to_the_west_texture


                       


                                
EA ./path_to_the_east_texture









F 220,                                                                                   100         ,                                0
C 225,30,0










        1111111111111111111111111
        1111000000001100000000001
        1011000001110000000000001
        1001000000000000000000001
111111111011000001110000000000001
100000000011000001110111111111111111111111
110000000000000000000000000001
111100000000000000000000000011
110000000000000000000000000001
10000000000000000000000000011
10000000000000000000N00000011
11000001110000011100000000111
11000001 1110101 100000000011
11111111 1111111 111111111111
                                                    
    



           