                        NO ./path_to_the_north_texture
SO ./path_to_the_south_texture





                                  
WE ./path_to_the_west_texture


                       


                                
EA ./path_to_the_east_texture









F 220,                                                                                   100         ,                                0
C 225,30,0











11111111111111111111111111111111111
1111111111010000000011000000000011111111111111
1111111111011000001110000000000000000000000001
1111111100100000000000000000000001111111000011
11111110000000000000000000000000111    1111011
1000000000110000000000000000000011111111111011111
10000000000000000000000000000000000000000000011
10010E0000000000000000000000111111111111111111
101000000000000000000000000111
1000000000000000000000000000111
11000001110000011100000001111
11000001 1110101 100000001011
11111111 1111111 111111111111
                                                    
    



           