NO ./path_to_the_north_texture
SO ./path_to_the_south_texture





                                  
WE ./path_to_the_west_texture


                       


                                
EA ./path_to_the_east_texture









F 220,                                                                                   100         ,                                0
C 225,30,0










        1111111111111111111111111
        1111000000001100000000001
        1011000001110000000000001
        1001000000000000000000001
111111111011000001110000000000001
100000000011000001110111111111111111111111
11110111111111011100000010001
11110111111111011110100101011
11000000111111011100000010001
11001001001010011000000100011
1001000100000011010N001000111
1100000111010101111101111000111
11110111 1110101 1011110100011
11111111 1111111 111111111111
                                                    
    



           