
EA ./path_to_the_east_texture


NO ./path_to_the_north_texture
WE ./path_to_the_west_texture
SO ./path_to_the_south_texture

F 41,40,38

C 192,223,239
                   
C 150,50,255

WE ./path_to_the_west_texture
SO ./path_to_the_south_texture

								
        11111
        11111
        100001111111
        1000000000011111111111111111111
        10000000000000000000000000000011
1111111110000000000000000000000000000011111111111
10000000000000000000000000000000000000000000000111
1000000E000000000000000000000000000000000000000001
11111111111111110111111111111111111111111111111111
               10111111111111111
               101111111111111                 
               11111111
               1111 1
			   










            
