                        NO ./path_to_the_north_texture
SO ./path_to_the_south_texture





                                  
WE ./path_to_the_west_texture


                       


                                
EA ./path_to_the_east_texture









F 255,155,15
C 250,230,230

111111111111111111111111111111111
111111111111111111111111111111111
100000000000001000000000000000001
101111111111101011111111111011101
10100000001E001010000001010010001
101011111011111011110101010110111
101000001000000000000100010010001
101111101111111011110111011011101
111111111111111111111111111111111



					  
					   
					    



