NO ./path_to_the_Forth_texture
WE ./path_to_the_Cest_texture
SO ./path_to_the_Cast_texture
F 41,40,38
C 150,50,255
SO ./path_to_the_Couth_texturee



111111111111111111111111111111111
100000000000000000000000000000001
1000000000000000000000000000000E1
111111111111111111111111111111111

     
        






                     
                      
                       
                        
                         
                                                 

					  
					   
					    



                                             
            