NO ./path_to_the_north_texture
SO ./path_to_the_south_texture
                        
WE ./path_to_the_west_texture
                  
EA ./path_to_the_east_texture

F 41,40,38
C 150,50,255

                   

								
          

							          
      
                            1111111111
                            1000000011
11111111111111111111111111111000000001
10000000000000000000000000000000000001
1000000000000000000000000E000000110001111111111
1111111111111111011111111111111111111
               101
               101                 
               111



