NO ./path_to_the_north_texture
SO ./path_to_the_south_texture





                                  
WE ./path_to_the_west_texture


                       


                                
EA ./path_to_the_east_texture









F 220,                                                                                   100         ,                                0
C 225,30,0










11111111111111111111111111111111111
111111111101000000001100000000001
1111111111011000001110000000000001
1111111111001000000000000000000001
111111111011000001110000000000001
100000000011000001110111111111111111111111
110000000000000000000000000001
111100000000000000000000000011
110000000000000000E00000000001
10100000000000000000000001011
10000000000000000000000000011
11000001110000011100000001111
11000001 1110101 100000001011
11111111 1111111 111111111111
                                                    
    



           